imit	imita	imitʃi	imitʃi
imik	imika	imiki	imiki
imid	imida	imidʒi	imidʒi
imig	imiga	imigi	imigi
imat	imata	imatʃi	imatʃi
imak	imaka	imaki	imaki
imad	imada	imadʒi	imadʒi
imag	imaga	imagi	imagi
imut	imuta	imutʃi	imutʃi
imuk	imuka	imuki	imuki
imud	imuda	imudʒi	imudʒi
imug	imuga	imugi	imugi
init	inita	initʃi	initʃi
inik	inika	iniki	iniki
inid	inida	inidʒi	inidʒi
inig	iniga	inigi	inigi
inat	inata	inatʃi	inatʃi
inak	inaka	inaki	inaki
inad	inada	inadʒi	inadʒi
inag	inaga	inagi	inagi
inut	inuta	inutʃi	inutʃi
inuk	inuka	inuki	inuki
inud	inuda	inudʒi	inudʒi
inug	inuga	inugi	inugi
ilit	ilita	ilitʃi	ilitʃi
ilik	ilika	iliki	iliki
ilid	ilida	ilidʒi	ilidʒi
ilig	iliga	iligi	iligi
ilat	ilata	ilatʃi	ilatʃi
ilak	ilaka	ilaki	ilaki
ilad	ilada	iladʒi	iladʒi
ilag	ilaga	ilagi	ilagi
ilut	iluta	ilutʃi	ilutʃi
iluk	iluka	iluki	iluki
ilud	iluda	iludʒi	iludʒi
ilug	iluga	ilugi	ilugi
umit	umita	umitʃi	umitʃi
umik	umika	umiki	umiki
umid	umida	umidʒi	umidʒi
umig	umiga	umigi	umigi
umat	umata	umatʃi	umatʃi
umak	umaka	umaki	umaki
umad	umada	umadʒi	umadʒi
umag	umaga	umagi	umagi
umut	umuta	umutʃi	umutʃi
umuk	umuka	umuki	umuki
umud	umuda	umudʒi	umudʒi
umug	umuga	umugi	umugi
unit	unita	unitʃi	unitʃi
unik	unika	uniki	uniki
unid	unida	unidʒi	unidʒi
unig	uniga	unigi	unigi
unat	unata	unatʃi	unatʃi
unak	unaka	unaki	unaki
unad	unada	unadʒi	unadʒi
unag	unaga	unagi	unagi
unut	unuta	unutʃi	unutʃi
unuk	unuka	unuki	unuki
unud	unuda	unudʒi	unudʒi
unug	unuga	unugi	unugi
ulit	ulita	ulitʃi	ulitʃi
ulik	ulika	uliki	uliki
ulid	ulida	ulidʒi	ulidʒi
ulig	uliga	uligi	uligi
ulat	ulata	ulatʃi	ulatʃi
ulak	ulaka	ulaki	ulaki
ulad	ulada	uladʒi	uladʒi
ulag	ulaga	ulagi	ulagi
ulut	uluta	ulutʃi	ulutʃi
uluk	uluka	uluki	uluki
ulud	uluda	uludʒi	uludʒi
ulug	uluga	ulugi	ulugi
