imit	imita	imiči	imiči
imik	imika	imiki	imiki
imid	imida	imiǰi	imiǰi
imig	imiga	imigi	imigi
imat	imata	imači	imači
imak	imaka	imaki	imaki
imad	imada	imaǰi	imaǰi
imag	imaga	imagi	imagi
imut	imuta	imuči	imuči
imuk	imuka	imuki	imuki
imud	imuda	imuǰi	imuǰi
imug	imuga	imugi	imugi
init	inita	iniči	iniči
inik	inika	iniki	iniki
inid	inida	iniǰi	iniǰi
inig	iniga	inigi	inigi
inat	inata	inači	inači
inak	inaka	inaki	inaki
inad	inada	inaǰi	inaǰi
inag	inaga	inagi	inagi
inut	inuta	inuči	inuči
inuk	inuka	inuki	inuki
inud	inuda	inuǰi	inuǰi
inug	inuga	inugi	inugi
ilit	ilita	iliči	iliči
ilik	ilika	iliki	iliki
ilid	ilida	iliǰi	iliǰi
ilig	iliga	iligi	iligi
ilat	ilata	ilači	ilači
ilak	ilaka	ilaki	ilaki
ilad	ilada	ilaǰi	ilaǰi
ilag	ilaga	ilagi	ilagi
ilut	iluta	iluči	iluči
iluk	iluka	iluki	iluki
ilud	iluda	iluǰi	iluǰi
ilug	iluga	ilugi	ilugi
umit	umita	umiči	umiči
umik	umika	umiki	umiki
umid	umida	umiǰi	umiǰi
umig	umiga	umigi	umigi
umat	umata	umači	umači
umak	umaka	umaki	umaki
umad	umada	umaǰi	umaǰi
umag	umaga	umagi	umagi
umut	umuta	umuči	umuči
umuk	umuka	umuki	umuki
umud	umuda	umuǰi	umuǰi
umug	umuga	umugi	umugi
unit	unita	uniči	uniči
unik	unika	uniki	uniki
unid	unida	uniǰi	uniǰi
unig	uniga	unigi	unigi
unat	unata	unači	unači
unak	unaka	unaki	unaki
unad	unada	unaǰi	unaǰi
unag	unaga	unagi	unagi
unut	unuta	unuči	unuči
unuk	unuka	unuki	unuki
unud	unuda	unuǰi	unuǰi
unug	unuga	unugi	unugi
ulit	ulita	uliči	uliči
ulik	ulika	uliki	uliki
ulid	ulida	uliǰi	uliǰi
ulig	uliga	uligi	uligi
ulat	ulata	ulači	ulači
ulak	ulaka	ulaki	ulaki
ulad	ulada	ulaǰi	ulaǰi
ulag	ulaga	ulagi	ulagi
ulut	uluta	uluči	uluči
uluk	uluka	uluki	uluki
ulud	uluda	uluǰi	uluǰi
ulug	uluga	ulugi	ulugi
