imit	imita	imiči	imita
imik	imika	imiki	imika
imid	imida	imiǰi	imida
imig	imiga	imigi	imiga
imat	imata	imači	imata
imak	imaka	imaki	imaka
imad	imada	imaǰi	imada
imag	imaga	imagi	imaga
imut	imuta	imuči	imuta
imuk	imuka	imuki	imuka
imud	imuda	imuǰi	imuda
imug	imuga	imugi	imuga
init	inita	iniči	inita
inik	inika	iniki	inika
inid	inida	iniǰi	inida
inig	iniga	inigi	iniga
inat	inata	inači	inata
inak	inaka	inaki	inaka
inad	inada	inaǰi	inada
inag	inaga	inagi	inaga
inut	inuta	inuči	inuta
inuk	inuka	inuki	inuka
inud	inuda	inuǰi	inuda
inug	inuga	inugi	inuga
ilit	ilita	iliči	ilita
ilik	ilika	iliki	ilika
ilid	ilida	iliǰi	ilida
ilig	iliga	iligi	iliga
ilat	ilata	ilači	ilata
ilak	ilaka	ilaki	ilaka
ilad	ilada	ilaǰi	ilada
ilag	ilaga	ilagi	ilaga
ilut	iluta	iluči	iluta
iluk	iluka	iluki	iluka
ilud	iluda	iluǰi	iluda
ilug	iluga	ilugi	iluga
umit	umita	umiči	umita
umik	umika	umiki	umika
umid	umida	umiǰi	umida
umig	umiga	umigi	umiga
umat	umata	umači	umata
umak	umaka	umaki	umaka
umad	umada	umaǰi	umada
umag	umaga	umagi	umaga
umut	umuta	umuči	umuta
umuk	umuka	umuki	umuka
umud	umuda	umuǰi	umuda
umug	umuga	umugi	umuga
unit	unita	uniči	unita
unik	unika	uniki	unika
unid	unida	uniǰi	unida
unig	uniga	unigi	uniga
unat	unata	unači	unata
unak	unaka	unaki	unaka
unad	unada	unaǰi	unada
unag	unaga	unagi	unaga
unut	unuta	unuči	unuta
unuk	unuka	unuki	unuka
unud	unuda	unuǰi	unuda
unug	unuga	unugi	unuga
ulit	ulita	uliči	ulita
ulik	ulika	uliki	ulika
ulid	ulida	uliǰi	ulida
ulig	uliga	uligi	uliga
ulat	ulata	ulači	ulata
ulak	ulaka	ulaki	ulaka
ulad	ulada	ulaǰi	ulada
ulag	ulaga	ulagi	ulaga
ulut	uluta	uluči	uluta
uluk	uluka	uluki	uluka
ulud	uluda	uluǰi	uluda
ulug	uluga	ulugi	uluga
