imit	imita	imitʃi	imita
imik	imika	imiki	imika
imid	imida	imidʒi	imida
imig	imiga	imigi	imiga
imat	imata	imatʃi	imata
imak	imaka	imaki	imaka
imad	imada	imadʒi	imada
imag	imaga	imagi	imaga
imut	imuta	imutʃi	imuta
imuk	imuka	imuki	imuka
imud	imuda	imudʒi	imuda
imug	imuga	imugi	imuga
init	inita	initʃi	inita
inik	inika	iniki	inika
inid	inida	inidʒi	inida
inig	iniga	inigi	iniga
inat	inata	inatʃi	inata
inak	inaka	inaki	inaka
inad	inada	inadʒi	inada
inag	inaga	inagi	inaga
inut	inuta	inutʃi	inuta
inuk	inuka	inuki	inuka
inud	inuda	inudʒi	inuda
inug	inuga	inugi	inuga
ilit	ilita	ilitʃi	ilita
ilik	ilika	iliki	ilika
ilid	ilida	ilidʒi	ilida
ilig	iliga	iligi	iliga
ilat	ilata	ilatʃi	ilata
ilak	ilaka	ilaki	ilaka
ilad	ilada	iladʒi	ilada
ilag	ilaga	ilagi	ilaga
ilut	iluta	ilutʃi	iluta
iluk	iluka	iluki	iluka
ilud	iluda	iludʒi	iluda
ilug	iluga	ilugi	iluga
umit	umita	umitʃi	umita
umik	umika	umiki	umika
umid	umida	umidʒi	umida
umig	umiga	umigi	umiga
umat	umata	umatʃi	umata
umak	umaka	umaki	umaka
umad	umada	umadʒi	umada
umag	umaga	umagi	umaga
umut	umuta	umutʃi	umuta
umuk	umuka	umuki	umuka
umud	umuda	umudʒi	umuda
umug	umuga	umugi	umuga
unit	unita	unitʃi	unita
unik	unika	uniki	unika
unid	unida	unidʒi	unida
unig	uniga	unigi	uniga
unat	unata	unatʃi	unata
unak	unaka	unaki	unaka
unad	unada	unadʒi	unada
unag	unaga	unagi	unaga
unut	unuta	unutʃi	unuta
unuk	unuka	unuki	unuka
unud	unuda	unudʒi	unuda
unug	unuga	unugi	unuga
ulit	ulita	ulitʃi	ulita
ulik	ulika	uliki	ulika
ulid	ulida	ulidʒi	ulida
ulig	uliga	uligi	uliga
ulat	ulata	ulatʃi	ulata
ulak	ulaka	ulaki	ulaka
ulad	ulada	uladʒi	ulada
ulag	ulaga	ulagi	ulaga
ulut	uluta	ulutʃi	uluta
uluk	uluka	uluki	uluka
ulud	uluda	uludʒi	uluda
ulug	uluga	ulugi	uluga
