be	beim	bwa
bu	buim	bwa
ba	baim	bwa
bi	biim	bwa
de	deim	dwa
du	duim	dwa
da	daim	dwa
di	diim	dwa
ge	geim	gwa
gu	guim	gwa
ga	gaim	gwa
gi	giim	gwa
me	meim	mwa
mu	muim	mwa
ma	maim	mwa
mi	miim	mwa
je	jeim	jwa
ju	juim	jwa
ja	jaim	jwa
ji	jiim	jwa
we	weim	wwa
wu	wuim	wwa
wa	waim	wwa
wi	wiim	wwa
eβe	eβeim	ebwa
eβu	eβuim	ebwa
eβa	eβaim	ebwa
eβi	eβiim	ebwa
eze	ezeim	edwa
ezu	ezuim	edwa
eza	ezaim	edwa
ezi	eziim	edwa
eγe	eγeim	egwa
eγu	eγuim	egwa
eγa	eγaim	egwa
eγi	eγiim	egwa
eme	emeim	emwa
emu	emuim	emwa
ema	emaim	emwa
emi	emiim	emwa
eje	ejeim	ejwa
eju	ejuim	ejwa
eja	ejaim	ejwa
eji	ejiim	ejwa
ewe	eweim	ewwa
ewu	ewuim	ewwa
ewa	ewaim	ewwa
ewi	ewiim	ewwa
uβe	uβeim	ubwa
uβu	uβuim	ubwa
uβa	uβaim	ubwa
uβi	uβiim	ubwa
uze	uzeim	udwa
uzu	uzuim	udwa
uza	uzaim	udwa
uzi	uziim	udwa
uγe	uγeim	ugwa
uγu	uγuim	ugwa
uγa	uγaim	ugwa
uγi	uγiim	ugwa
ume	umeim	umwa
umu	umuim	umwa
uma	umaim	umwa
umi	umiim	umwa
uje	ujeim	ujwa
uju	ujuim	ujwa
uja	ujaim	ujwa
uji	ujiim	ujwa
uwe	uweim	uwwa
uwu	uwuim	uwwa
uwa	uwaim	uwwa
uwi	uwiim	uwwa
aβe	aβeim	abwa
aβu	aβuim	abwa
aβa	aβaim	abwa
aβi	aβiim	abwa
aze	azeim	adwa
azu	azuim	adwa
aza	azaim	adwa
azi	aziim	adwa
aγe	aγeim	agwa
aγu	aγuim	agwa
aγa	aγaim	agwa
aγi	aγiim	agwa
ame	ameim	amwa
amu	amuim	amwa
ama	amaim	amwa
ami	amiim	amwa
aje	ajeim	ajwa
aju	ajuim	ajwa
aja	ajaim	ajwa
aji	ajiim	ajwa
awe	aweim	awwa
awu	awuim	awwa
awa	awaim	awwa
awi	awiim	awwa
iβe	iβeim	ibwa
iβu	iβuim	ibwa
iβa	iβaim	ibwa
iβi	iβiim	ibwa
ize	izeim	idwa
izu	izuim	idwa
iza	izaim	idwa
izi	iziim	idwa
iγe	iγeim	igwa
iγu	iγuim	igwa
iγa	iγaim	igwa
iγi	iγiim	igwa
ime	imeim	imwa
imu	imuim	imwa
ima	imaim	imwa
imi	imiim	imwa
ije	ijeim	ijwa
iju	ijuim	ijwa
ija	ijaim	ijwa
iji	ijiim	ijwa
iwe	iweim	iwwa
iwu	iwuim	iwwa
iwa	iwaim	iwwa
iwi	iwiim	iwwa
